################################
#                              #
#                              #
#                              #
######                         #
#                              #
#                              #
#                              #
##########                     #
#                              #
#                              #
##############                 #
#                              #
#                              #
#     ###################      #
#                              #
#                            ###
#                              #
#                              #
#####################    #######
#                              #
#                              #
#                              #
###############    #############
#                              #
#                              #
#                              #
#        ####################### 
#                              #
#                              #
#             P                #
################################