################################
#                              #
#                              #
#                              #
#                              #
#                              #
#                              #
#                              #
#                              #
#                              #
#                              #
#                              #
#                              #
#                              #
#                              #
#                              #
#                            ###
#                              #
#                              #
#                        #######
#                              #
#                              #
#                              #
#                  #############
#                              #
#                              #
#                              #
#        ####################### 
#                              #
#                              #
#             P                #
################################