#   ################
#                  #
#                  #
#        N         #
####################
#                  #
#                  #
#                  #
#      P    P      #
#    __________    #
#                  #
#                  #
#                  #
#                  #
#                  #
#                  #
#                  #
#                  #
#              F   #
#   ################