#  ##  ##  ##  ##  #
#  N            N  #
#  __  __  __  __  #
#                  #
#    __  __  __    #
#                  #
#  __  __  __  __  #
#     P      P     #
#    __  __  __    #
#                  #
#  __  __  __  __  #
#                  #
#    __  __  __    #
#  N           N   #
#  __  __  __  __  #
#                  #
#    __  __  __    #
#                  #
#  __  __  __  __  #
#  ##  ##  ##  ##  #