#  #####   ######  #
# N              N #
#__              __#
#     N      N     #
#   ____________   #
#                  #
#                  #
#                  #
#       ____       #
#                  #
#                  #
#       ____       #
#                  #
#                  #
#                  #
#   ____________   #
#                  #
#                  #
#   P         P    #
#  _____   ______  #