####################
# _____     ______ #
#      P   P       #
#      _____       #
#                  #
#                  #
#                  #
#                  #
#                  #
#                  #
#                  #
#                  #
#                  #
#                  #
#     F      F     #
#    ___    ___    #
#                  #
#                  #
# N  F   N   F  N  #
####################