#  #################
#         F  N     #
################   #
#        F  N      #
#   ################
#          F  N    #
################   #
#                  #
#                  #
#  P       P       #
# ________________ #
#                  #
#                  #
#                  #
#              N ###
#            #######
#       N ##########
#      #############
#   ################
#  #################