#     ##############
#                  #
#                  #
#        N         #
####################
#                  #
#                  #
#                  #
#      P  V  P     #
#    __________    #
#                  #
#                  #
#                  #
#                  #
#                  #
#                  #
#                  #
#                  #
#              F   #
#     ##############