####################
#                  #
#                  #
#      P    P      #
#    __________    #
#                  #
#                  #
#                  #
#      F    Z      #
#    __________    #
#                  #
#                  #
#                  #
#                  #
#                  #
#                  #
#                  #
#                  #
#        N         #
####################