#########   ########
#                  #
#                  #
#      N   N       #
#    __________    #
#                  #
#                  #
#                  #
#                  #
#    N       N     #
#  ______________  #
#                  #
#                  #
#                  #
#                  #
#                  #
#                  #
#                  #
    P  C       P    
#########   ########