##   ###############
#                  #
#                  #
#        N         #
#__________________#
#                  #
#                  #
#                  #
#      P    P      #
#    __________    #
#                  #
#                  #
#                  #
#                  #
#                  #
#                  #
#                  #
#                  #
              F     
##   ###############