####################
#                  #
#                  #
#      P    P      #
#    __________    #
#                  #
#                  #
#                  #
#      F    F      #
#    __________    #
#                  #
#                  #
#                  #
#                  #
#                  #
#                  #
#                  #
#                  #
#        N         #
####################