####################
#                  #
#                  #
#                  #
#                  #
#                  #
#     P     P      #
#   ____________   #
#                  #
#                  #
#                  #
#                  #
#                  #
#                  #
#                  #
#      N ## N      #
#      ######      #
#    ##########    #
   ##############   
####################