#  ##############  #
#                  #
#N        V       N#
#_____        _____#
#                  #
#         N        #
#  ______________  #
#                  #
#                  #
#   N          N   #
#_______    _______#
#                  #
#                  #
#  N            N  #
 ______      ______ 
#                  #
#                  #
#                  #
    P          P    
#  ##############  #