####################
#                  #
#                  #
#                  #
#           FFFFFFF#
#      ____________#
#                  #
###                #
########FFFF       #
########______     #
#                  #
#N               ###
#_________     #####
#            #######
#          #########
#        ###########
#      #############
#    ###############
#P #################
####################