####################
#                  #
#                  #
#                  #
#                  #
#                  #
#              #####
#                  #
#                  #
#          #########
#                  #
#                  #
########           #
#                  #
#                  #
#############      #
#                  #
#        P         #
####################
