####################
#                 F#
#              FFFF#
#           FFFFFFF#
#        FFFFFFFFFF#
#      ____________#
#                  #
###                #
########FFFF       #
########______     #
#                  #
#N               ###
#_________     #####
#            #######
#          #########
#        ###########
#      #############
#    ###############
#P #################
####################