########   #########
#   N              #
########           #
#              N   #
#          #########
#                  #
#                  #
#               ####
#                  #
#          ###     #
#                  #
#   ###            #
#                  #
#              P   #
#     ##   #########
####               #
#                  #
#                  #
########   #########