####################
#                  #
#                  #
#                  #
#          N       #
#       ___________#
#                  #
###                #
######## F         #
########______     #
#                  #
# N                #
#__________       F#
#               ####
#               ####
#          #########
#        ###########
#     ##############
#P #################
####################