####################
#              FFFF#
#           FFFFFFF#
#        FFFFFFFFFF#
#      #############
#                  #
###                #
########FFFF       #
##############     #
#                  #
#N               ###
##########     #####
#            #######
#          #########
#        ###########
#      #############
#    ###############
#P #################
####################
