########   #########
#_______   ________#
#                  #
#   N              #
#_______       N   #
#          ________#
#                  #
#                  #
#               ___#
#                  #
#          ___     #
#                  #
#   ___            #
#                  #
#              P   #
#     __   ________#
#___               #
#                  #
#                  #
########   #########