########   #########
#                  #
#                  #
#                  #
#_______       N   #
#          ________#
#                  #
#                 _#
#                  #
#                  #
#          ________#
# N                #
#______            #
#                  #
#      F    P   P  #
#     __   ________#
#___               #
#                  #
#                  #
#_______   ________#