####################
#                  #
#            ______#
#                  #
#       ___________#
#                  #
#    ______________#
#_                 #
#                  #
#____              #
#                  #
#________          #
# N                #
#____________      #
#           _____  #
#                  #
#    ______________#
#                  #
# P P         N    #
####################
