########   #########
#_______   ________#
#                  #
#   N              #
#_______       N   #
#          ________#
#                  #
#                  #
#               ___#
#    FF            #
#          ___     #
#              P   #
#   ___            #
#                  #
#                  #
#     __   ________#
#___               #
#                  #
#                  #
#_______   ________#