####################
#                FF#
#             FFFFF#
#            ______#
#        FFFFFFFFFF#
#       ___________#
#    FFFFFFFFFFFFFF#
#    ______________#
#_              FFF#
#FF           _____#
#____              #
#FFFFFFF           #
#________          #
# N                #
#____________      #
#           _____  #
#      FFFFFFFFFFFF#
#    ______________#
#  P          N    #
####################
