####################
#                  #
#                  #
#                  #
#                  #
#                  #
#                  #
#                  #
#                  #
#                  #
#                  #
#                  #
#                  #
#                  #
#                  #
#                  #
#                  #
#        P         #
####################
