####################
#                FF#
#             FFFFF#
#            ______#
#                  #
#       ___________#
#                  #
#    ______________#
#_                 #
#FF                #
#____              #
#FFF               #
#________          #
# N                #
#____________      #
#           _____  #
#      FFFFFFFFFFFF#
#    ______________#
#  P          N    #
####################
