####################
#                FF#
#             FFFFF#
#            #######
#        FFFFFFFFFF#
#       ############
#    FFFFFFFFFFFFFF#
#    ###############
##              FFF#
#FF           ######
#####              #
#FFFFFFF           #
#########          #
# N                #
#############      #
#           #####  #
#      FFFFFFFFFFFF#
#    ###############
#  P          N    #
####################
