########   #########
#                  #
#                  #
#                  #
#_______       N   #
#          ________#
#                  #
#                 _#
#                  #
#                  #
#          ________#
# N            P   #
#______            #
#                  #
#      F           #
#     __   ________#
#___               #
#                  #
#                  #
#_______   ________#