####################
#                  #
#                  #
#                  #
#                  #
#                  #
#                  #
#                  #
#                  #
#                  #
#                  #
#                  #
########           #
#                  #
#                  #
#############      #
#                  #
#        P         #
####################
