########   #########
#                  #
#                  #
#   N              #
#_______       N   #
#          ________#
#                  #
#                  #
#               ___#
#    F             #
#          ___     #
#              P   #
#   ___            #
#                  #
#           P      #
#     __   ________#
#___               #
#                  #
#                  #
#_______   ________#