####################
#   N              #
##########         #
#         N        #
#    ###########   #
#                  #
#                  #
#               ####
#                  #
#         ###      #
#                  #
#   ###            #
#                  #
#              P   #
#          #########
####               #
#                  #
#                  #
####################
